1111111
1C001E1
1P00011
1111111
