1111111
1000P01
1C00C01
10x0001
1E00001
1111111
