11111
1E001
10000
1P0C1
11111
